AIF	TVOD	AIFF	BINARY
AIFF	TVOD	AIFF	BINARY
AIFC	TVOD	AIFC	BINARY
AS	DmWr	TEXT	ASCII
ASCX	DmWr	TEXT	ASCII
ASMX	DmWr	TEXT	ASCII
ASP	DmWr	TEXT	ASCII
ASPX	DmWr	TEXT	ASCII
BIN	MB2P	BINA	BINARY
BMP	MKBY	BMP	BINARY
CFM	DmWr	TEXT	ASCII
CFML	DmWr	TEXT	ASCII
CGI	DmWr	TEXT	ASCII
CS	DmWr	TEXT	ASCII
CSS	DmWr	TEXT	ASCII
DCR	MD97	FGDC	BINARY
DIR	MD97	FGDC	BINARY
DMG	ddsk	devi	BINARY
DOC	MSWD	WDBN	BINARY
DOCX	MSWD	WDBN	BINARY
DWT	DmWr	TEXT	ASCII
DXR	MD97	FGDC	BINARY
EXE	????	APPL	BINARY
FLA	MFL2	SPA	BINARY
GIF	MKBY	GIFf	BINARY
HTM	DmWr	TEXT	ASCII
HTML	DmWr	TEXT	ASCII
INC	ttxt	TEXT	ASCII
JPG	MKBY	JPEG	BINARY
JPEG	MKBY	JPEG	BINARY
JS 	ttxt 	TEXT 	ASCII 
LBI	DmWr	TEXT	ASCII
MNO	DmWr	TEXT	BINARY
MOV	TVOD	MooV	BINARY
MPEG	mMPG	MPEG	BINARY
MPG	mMPG	MPEG	BINARY
MXML	DmWr	TEXT	ASCII
MXP	MmXm	MMXP	BINARY
PDF	CARO	PDF	BINARY
PHP	DmWr	TEXT	ASCII
PHP3	DmWr	TEXT	ASCII
PHP4	DmWr	TEXT	ASCII
PHP5	DmWr	TEXT	ASCII
PIC	MKBY	PICT	BINARY
PICT	MKBY	PICT	BINARY
PL	DmWr	TEXT	ASCII
PNG	MKBY	PNGf	BINARY
PSD	8BIM	8BIM	BINARY
QT	TVOD	MooV	BINARY
RA	PNst	PNRE	BINARY
RAM	PNst	PNRM	BINARY
README ttxt	TEXT	BINARY
RM	PNst	PNRA	BINARY
RTF	MSWD	TEXT	BINARY
SEA	????	APPL	BINARY
SHTM	DmWr	TEXT	ASCII
SHTML	DmWr	TEXT	ASCII
SIT	SIT!	SITD	BINARY
SND	SCPL	BINA	BINARY
SWF	SWF2	SWFL	BINARY
TEXT	ttxt	TEXT	ASCII
TIF	MKBY	TIFF	BINARY
TIFF	MKBY	TIFF	BINARY
TPL	DmWr	TEXT	BINARY
TXT	ttxt	TEXT	ASCII
VB	DmWr	TEXT	ASCII
WAV	TVOD	WAVE	BINARY
XHTM	DmWr	TEXT	ASCII
XHTML	DmWr	TEXT	ASCII
XLS	XCEL	XLS	BINARY
XLSX	XCEL	XLS	BINARY
ZIP	ZIP	ZIP	BINARY
